0,0,0,0,0,0,0,0,0,0,0,0,
0,1,0,1,1,1,1,1,1,1,0,0,
0,1,4,1,0,2,1,0,2,1,0,0,
0,1,0,1,0,1,0,0,1,1,1,0,
0,1,0,2,0,1,1,4,1,1,1,0,
0,1,1,1,0,3,1,1,1,4,1,0,
0,1,2,1,1,4,1,1,1,1,1,0,
0,1,0,0,1,0,1,1,0,0,1,0,
0,0,0,0,0,0,0,0,0,0,0,0,
0,0,0,0,0,0,0,0,0,0,0,0,
0,0,0,0,0,2,2,0,0,0,0,0,
0,0,0,0,0,1,1,0,0,0,0,0,
0,0,0,0,0,4,4,0,0,0,0,0,
0,2,1,1,4,3,1,4,1,1,2,0,
0,0,0,0,0,4,4,0,0,0,0,0,
0,0,0,0,0,1,1,0,0,0,0,0,
0,0,0,0,0,2,2,0,0,0,0,0,
0,0,0,0,0,0,0,0,0,0,0,0,
0,0,0,0,0,0,0,0,0,0,0,0,
0,3,5,5,5,0,0,0,0,0,0,0,
0,5,5,4,4,0,0,0,0,0,0,0,
0,5,5,4,5,0,0,0,2,2,2,0,
0,0,0,0,5,0,0,0,5,5,5,0,
0,0,0,0,5,5,5,5,5,5,5,0,
0,0,0,5,5,5,0,5,5,5,5,0,
0,0,0,5,5,5,0,0,0,0,0,0,
0,0,0,0,0,0,0,0,0,0,0,0,
0,0,0,0,0,0,0,0,0,0,0,0,
0,0,0,0,0,0,0,0,0,0,0,0,
0,0,0,3,5,0,0,0,0,0,0,0,
0,0,0,5,4,5,5,0,0,0,0,0,
0,0,0,0,5,0,5,0,0,0,0,0,
0,0,2,0,5,0,5,5,0,0,0,0,
0,0,2,4,5,5,0,1,0,0,0,0,
0,0,2,5,5,5,4,5,0,0,0,0,
0,0,0,0,0,0,0,0,0,0,0,0,