0,0,0,0,0,0,0,0,0,0,0,0,
0,5,5,5,5,5,5,5,5,5,5,0,
0,5,0,0,0,0,5,5,5,5,5,0,
0,5,0,0,0,0,5,5,5,5,5,0,
0,5,5,5,5,5,5,5,5,5,5,0,
0,5,2,5,4,5,3,5,5,5,5,0,
0,5,5,5,5,5,5,5,5,5,5,0,
0,5,5,0,0,0,5,5,5,5,5,0,
0,0,0,0,0,0,0,0,0,0,0,0,
0,0,0,0,0,0,0,0,0,0,0,0,
0,2,0,5,5,5,5,5,5,5,5,0,
0,4,0,5,0,0,0,0,0,0,5,0,
0,5,0,5,0,3,5,5,5,0,5,0,
0,5,0,5,0,0,0,0,5,0,5,0,
0,5,0,5,5,5,5,5,5,0,5,0,
0,5,0,0,0,0,0,0,0,0,5,0,
0,5,5,5,5,5,5,5,5,5,5,0,
0,0,0,0,0,0,0,0,0,0,0,0,
0,0,0,0,0,0,0,0,0,0,0,0,
0,0,0,0,0,5,5,5,5,5,5,0,
0,2,5,5,0,5,5,5,0,5,5,0,
0,4,5,5,0,3,5,5,0,5,5,0,
0,5,5,5,0,4,5,5,0,5,5,0,
0,5,5,5,0,2,5,5,0,5,5,0,
0,5,5,5,0,0,0,0,0,5,4,0,
0,5,5,5,5,5,5,5,5,5,2,0,
0,0,0,0,0,0,0,0,0,0,0,0,
0,0,0,0,0,0,0,0,0,0,0,0,
0,5,5,5,5,5,5,5,5,5,5,0,
0,5,5,5,5,5,5,5,5,5,5,0,
0,3,5,5,5,5,5,5,5,5,5,0,
0,5,5,5,5,5,5,5,5,5,5,0,
0,4,0,4,0,4,0,4,0,5,5,0,
0,5,0,5,0,5,0,5,0,5,5,0,
0,2,0,2,0,2,0,2,0,5,5,0,
0,0,0,0,0,0,0,0,0,0,0,0,
0,0,0,0,0,0,0,0,0,0,0,0,
0,2,0,5,5,5,5,0,5,2,5,0,
0,4,0,5,5,5,5,0,5,4,5,0,
0,5,0,5,5,5,5,0,5,5,5,0,
0,5,0,5,5,3,5,0,5,5,5,0,
0,5,5,5,5,5,5,5,5,5,5,0,
0,5,5,5,5,5,5,5,0,0,0,0,
0,5,5,5,5,5,5,5,5,4,2,0,
0,0,0,0,0,0,0,0,0,0,0,0,
